



NO ./textures/redbrick.xpm



SO              ./textures/greystone.xpm


WE               ./textures/colorstone.xpm


EA ./textures/wood.xpm


F           150 , 100, 100

C 30 , 30,200


111111111111111111111111111111 1
100000000000100010000000000001
100000000000000000000000000001
110000000000000000000000000011
10000000000000N000000000000001
110000000000000000000000000011
100000000000000000000000000001
100000000000001000100000000001
100000001111000000111110000001
11111111  111111111111111111111