NO ./textures/brick_brown_64x64.xpm
SO ./textures/brick_green_64x64.xpm
WE ./textures/wooden_box_64x64.xpm
EA ./textures/stones_64x64.xpm

111111111111111111111111111111
100000000000100010000000000001
100000000000000000000000000001
110000000000000000000000000011
10000000000000N000000000000001
110000000000000000000000000011
100000000000000000000000000001
100000000001001000100000000001
111111111111111111111111111111