NO ./textures/stone.xpm
SO ./textures/stone2.xpm
WE ./textures/wood.xpm
EA ./textures/eagle.xpm

F 100,150,200
C 130,30,200

        11111111111111111111111111
        10000000001100000000000001
        101100000111000000000000011
        10010000000000000W000000001
11111111101100000111000000000000111
100000000011000001110111111111111
11110111111111011100000010001
11110111111111011101010010001
11000000110101011100000010001
10000000000000001100000010001
10000000000000001101010010001
1100000111010101111101111000111
11110111 1110101 101111010001
11111111 1111111 111111111111