NO ./textures/stone.xpm
SO ./textures/stone2.xpm
WE ./textures/wood.xpm
EA ./textures/eagle.xpm


        11111111111111111111111111
        111111111111 1111111111111
        111111111111 011111111111
        111111111111001111111111 1
111111111011000001101N0110010100001111
10000000001100000111 1111111111111
11110111111111011100001000111111111111
11110111111111011101 10010001
11000000110101011100000010001
10000000000000001100000010001
100000000001000001101010010001
1100000111010101111101111000111
11110111 11101011101111010001
                                     
11111111 1111111 111111111111