NO
./textures/stone.xpm 
SO ./textures/stone2.xpm
WE ./textures/wood.xpm
EA ./textures/eagle.xpm

F 150,100,100
C 30,30,200

    111111111
    100000001
1111100111111
100N0001
10000001
11011111
11 11  1
